C 0,0,0
F 12,15,70


NO ./textures/pls.xpm
SO ./textures/pls.xpm
EA ./textures/pls.xpm
WE ./textures/pls.xpm


        1111111111111111111111111
        1000002000110000000000201
        1011000001110000000000001
        10010000000002000000W0001
111111111011000001110000000000001
100020000010000001110111100011111
11110110000001011100000010001
11110110000011011101010010001
11000000000101011100000010201
10000000000002001100000010001
10002000000000001101010010001
11000001110101011111011110001
11110111 1110101 101111010001
11111111 1111111 111111111111