C 0,0,0
F 12,15,70


NO ./textures/pls.xpm
SO ./textures/pls.xpm
EA ./textures/pls.xpm
WE ./textures/pls.xpm


        1111111111111111111111
        1000000000110S00000001
        1011000001110000000001111
        1001000000000000000000001
111111111011000001110000000000001
100000000011000001110001111111111
11110111111111011100000010001
11110111111111011100000010001
1100000011010101110000001000111
1000000000000000110000000000001
1000000000000000110100001000011
1100000111010101111100000000011
11110111 1110101 1011110000001
11111111 1111111 1111111111111